Sponky, klipy a zásobníky=Školní a kancelářské potřeby|Kancelářské potřeby|Sponky klipy zásobníky
Fixy Deli=Školní a kancelářské potřeby|Psací potřeby|Fixy
Fixy=Školní a kancelářské potřeby|Psací potřeby|Fixy
Spojovače=Školní a kancelářské potřeby|Kancelářské potřeby|Spojovače
Polystyren=Školní a kancelářské potřeby|Kreativ|Polystyren
Úklidový papír=LUMA NEZAŘAZENO|úklidový papír
Vodové a temperové barvy=Školní a kancelářské potřeby|Školní potřeby|Vodové a temperové barvy
Pouzdra=Školní a kancelářské potřeby|Kancelářské potřeby|Pouzdra
Stojánky=LUMA NEZAŘAZENO|Stojánky
DELI TOOLS=Ruční nářadí
Tavné pistole a náplně=Školní a kancelářské potřeby|Kreativ|Tavné pistole a náplně
Obálky bublinkové=Školní a kancelářské potřeby|Kancelářské potřeby|Obálky bublinkové
Akrylové  a olejové barvy=Školní a kancelářské potřeby|Školní potřeby|Akrylové a olejové barvy
Kuličková pera jednorázová=Školní a kancelářské potřeby|Psací potřeby|Kuličková pera
Ořezávátka=Školní a kancelářské potřeby|Školní potřeby|Ořezávátka
Vícebarevná a multifunkční pera=Školní a kancelářské potřeby|Psací potřeby|Vícebarevná a multifunkční pera
Lepící hmoty=Školní a kancelářské potřeby|Školní potřeby|Lepící hmoty
Nůžky=Školní a kancelářské potřeby|Kancelářské potřeby|Nůžky
Rozešívačky=Školní a kancelářské potřeby|Kancelářské potřeby|Rozešívačky
Samolepky a jiné=Školní a kancelářské potřeby|Kancelářské potřeby|Samolepky a jiné
Pera=Školní a kancelářské potřeby|Psací potřeby|Pera
Drátky žinylka a bužírky=Školní a kancelářské potřeby|Kreativ|Drátky žinylka a bužírky
Kuličková pera=Školní a kancelářské potřeby|Psací potřeby|Kuličková pera
Zmizíky=Školní a kancelářské potřeby|Psací potřeby|Zmizíky
MARKETINGOVÁ PODPORA=MARKETINGOVÁ PODPORA
Rychlovazače=Školní a kancelářské potřeby|Kancelářské potřeby|Rychlovazače
Odpadkové koše=Školní a kancelářské potřeby|Kancelářské potřeby|Odpadkové koše
Katalogové knihy=Školní a kancelářské potřeby|Kancelářské potřeby|Katalogové knihy
Odvíječe na lepící pásky=Školní a kancelářské potřeby|Kancelářské potřeby|Odvíječe na lepící pásky
Glitr a glitrová lepidla=Školní a kancelářské potřeby|Kreativ|Glitr a glitrová lepidla
Popisovače Deli=Školní a kancelářské potřeby|Psací potřeby|
Pravítka=Školní a kancelářské potřeby|Rýsovací potřeby|Pravítka
Stojánky na čtení=LUMA NEZAŘAZENO|Stojánky na čtení
Dárkové tašky=LUMA NEZAŘAZENO|Dárkové tašky
Obálky dopisní=Školní a kancelářské potřeby|Kancelářské potřeby|Obálky dopisní
Sešívačky=Školní a kancelářské potřeby|Kancelářské potřeby|Sešívačky
Barvy na sklo=Školní a kancelářské potřeby|Kreativ|Barvy na sklo
PRODEJNÍ STOJANY=LUMA NEZAŘAZENO|PRODEJNÍ STOJANY
Prezentace=LUMA NEZAŘAZENO|Prezentace
Jmenovky=LUMA NEZAŘAZENO|Jmenovky
Samolepící záložky, bločky=Školní a kancelářské potřeby|Kancelářské potřeby|Samolepící záložky, bločky
Štětce=Školní a kancelářské potřeby|Školní potřeby|Štětce
Lupy, zvětšovací skla=Školní a kancelářské potřeby|Kancelářské potřeby|Lupy, zvětšovací skla
Gelová pera=Školní a kancelářské potřeby|Psací potřeby|Gelová pera
Sáčky, tašky, pytle=LUMA NEZAŘAZENO|Sáčky, tašky, pytle
Papír=LUMA NEZAŘAZENO|Papír
Kalkulačky=Školní a kancelářské potřeby|Kancelářské potřeby|Kalkulačky
Kreativní papír=Školní a kancelářské potřeby|Kreativ|Kreativní papír
Spisové obálky=Školní a kancelářské potřeby|Kancelářské potřeby|Spisové obálky
Ostatní=Školní a kancelářské potřeby|Kreativ|Ostatní
Tabulky na psaní=Školní a kancelářské potřeby|Psací potřeby|Tabulky na psaní
Balící folie=Školní a kancelářské potřeby|Kancelářské potřeby|Balící folie
Bublifuky=Školní a kancelářské potřeby|Kreativ|Bublifuky
Obaly, desky a boxy na sešity=Školní a kancelářské potřeby|Školní potřeby|Obaly, desky a boxy na sešity
Stuhy a rozety=Školní a kancelářské potřeby|Kreativ|Stuhy a rozety
Špendlíky a připínáčky=Školní a kancelářské potřeby|Kancelářské potřeby|Špendlíky a připínáčky
Odkladače na dokumenty=Školní a kancelářské potřeby|Kancelářské potřeby|Odkladače na dokumenty
Masky=Školní a kancelářské potřeby|Kreativ|Masky
Tekutá lepidla=Školní a kancelářské potřeby|Školní potřeby|Tekutá lepidla
Oči=Školní a kancelářské potřeby|Kreativ|Oči
Magnety=Školní a kancelářské potřeby|Kancelářské potřeby|Magnety
Zvýrazňovače=Školní a kancelářské potřeby|Psací potřeby|Zvýrazňovače
Baterie=LUMA NEZAŘAZENO|Baterie
Náplně=Školní a kancelářské potřeby|Psací potřeby|Náplně
SAMOLEPKY=Školní a kancelářské potřeby|Kancelářské potřeby|Samolepky a jiné
Poznámkové bločky=Školní a kancelářské potřeby|Kancelářské potřeby|Poznámkové bločky
Navlhčovač=LUMA NEZAŘAZENO|Navlhčovač
Sisal a lýko=Školní a kancelářské potřeby|Kreativ|Sisal a lýko
Létající draci=Školní a kancelářské potřeby|Kreativ|Létající draci
Lampióny=Školní a kancelářské potřeby|Kreativ|Lampióny
Bambulky=Školní a kancelářské potřeby|Kreativ|Bambulky
Svíčky=Školní a kancelářské potřeby|Kreativ|Svíčky
Rozlišovače plastové=Školní a kancelářské potřeby|Kancelářské potřeby|Hřbety plastové
Omalovánky, hry=Školní a kancelářské potřeby|Kreativ|Omalovánky, hry
Bloky=Školní a kancelářské potřeby|Školní potřeby|Bloky
Skicáky a náčrtníky=Školní a kancelářské potřeby|Školní potřeby|Skicáky a náčrtníky
Pokladní kotoučky=LUMA NEZAŘAZENO|Pokladní kotoučky
Filc a moosgummi=Školní a kancelářské potřeby|Kreativ|Filc a moosgummi
Párty výzdoba=Školní a kancelářské potřeby|Kreativ|Párty výzdoba
Xerografické papíry=LUMA NEZAŘAZENO|Xerografické papíry
Psací podložky s klipem=Školní a kancelářské potřeby|Kancelářské potřeby|Psací podložky s klipem
Pytle na odpadky=Školní a kancelářské potřeby|Kancelářské potřeby|Pytle na odpadky
Popisovače=Školní a kancelářské potřeby|Psací potřeby|Popisovače
Bloky se spirálou=Školní a kancelářské potřeby|Školní potřeby|Bloky
Odlamovací nože=Školní a kancelářské potřeby|Kancelářské potřeby|Odlamovací nože
Kružítka=Školní a kancelářské potřeby|Rýsovací potřeby|Kružítka
Korekční strojky, tužky a laky=Školní a kancelářské potřeby|Kancelářské potřeby|Koreční strojky, tužky a laky
Balící papíry=Školní a kancelářské potřeby|Kancelářské potřeby|Balící papíry
Barevné peří=Školní a kancelářské potřeby|Kreativ|Barevné peří
Kroužkové pořadače=Školní a kancelářské potřeby|Kancelářské potřeby|Kroužkové pořadače
Desky na spisy=Školní a kancelářské potřeby|Kancelářské potřeby|Desky na spisy
Mikrotužky=Školní a kancelářské potřeby|Psací potřeby|Mikrotužky
Zvýrazňovače Deli=Školní a kancelářské potřeby|Psací potřeby|Zvýrazňovače
Sešity=Školní a kancelářské potřeby|Školní potřeby|Sešity
Balónky foliové=Školní a kancelářské potřeby|Kreativ|Balónky
Balónky obyčejné=Školní a kancelářské potřeby|Kreativ|Balónky
Kroužkové bloky=Školní a kancelářské potřeby|Školní potřeby|Bloky
Desky s rychlosvorkou=Školní a kancelářské potřeby|Kancelářské potřeby|Desky s rychlosvorkou
Pastelky a voskové pastely=Školní a kancelářské potřeby|Školní potřeby|Pastelky a voskové pastely
Křídy=Školní a kancelářské potřeby|Školní potřeby|Křídy
Motouzy=Školní a kancelářské potřeby|Kreativ|Motouzy
Párty stolování=Školní a kancelářské potřeby|Kreativ|Párty výzdoba
Památníky=Školní a kancelářské potřeby|Kreativ|Památníky
OCHRANNÉ PROSTŘEDKY=LUMA NEZAŘAZENO|OCHRANNÉ PROSTŘEDKY
Pryže=Školní a kancelářské potřeby|Školní potřeby|Pryže
Záznamní knihy=Školní a kancelářské potřeby|Školní potřeby|Záznamní knihy
Děrovačky=Školní a kancelářské potřeby|Kancelářské potřeby|Děrovačky
Krepový papír=Školní a kancelářské potřeby|Kreativ|Krepový papír
Tuhá lepidla=Školní a kancelářské potřeby|Kancelářské potřeby|Tuhá lepidla
Aktovky spisové=Školní a kancelářské potřeby|Kancelářské potřeby|Aktovky spisové
Lepící pásky=Školní a kancelářské potřeby|Školní potřeby|Lepící pásky
Jednorázové nádobí=Školní a kancelářské potřeby|Kreativ|Párty výzdoba
Tužky=Školní a kancelářské potřeby|Psací potřeby|
Modelovací hmoty=Školní a kancelářské potřeby|Kreativ|Modelovací hmoty
Ubrousky=Školní a kancelářské potřeby|Kreativ|Párty výzdoba